12
10
6
######____
#____#____
#__$_####_
#_$$_#__##
#_#_##$__#
#...__.._#
#######_##
#___##___#
#@$___.$_#
#___##___#
#___######
#####_____
