10
10
9
##########
#_______@#
#_$#####_#
#__#...#_#
#_$$...#_#
#__#...$_#
#_$##$##_#
#__$_$_$_#
#________#
##########
