7
8
5
########
#....._#
#$_##$_#
#_$##__#
#__$@$_#
#_____##
########
