7
7
4
#######
#_____#
#__$$_#
#_$_$@#
#..####
#..#___
####___
