8
13
6
________#####
#########___#
#__......$__#
#___#$###___#
###_$@$_#___#
__#_$_$_#___#
__#_____#####
__#######____
