5
7
2
#######
#____.#
#__$$.#
#__#_@#
#######
