11
23
19
#######################
#_____________________#
#_##################$##
#_#...#____________#__#
#_#...#_$$$$$$$$_#_#__#
#_#..$__$______$#._$__#
#_#___#___$$$$$$.#_#__#
#_#...#_#_.....#___.###
#_#################$__#
#+____________________#
#######################
