9
8
4
########
##_._###
##.____#
#.._##_#
#_#__#_#
#_$__$_#
##_$$###
_#@__#__
_#####__

