6
8
2
########
#___#_.#
#___$$+#
####___#
___#___#
___#####
